111111111111111111111111111111111111111111111111111111111111
1S00000000000000000000000000000000000000200000000000000000S1
100000000000000000000000000000000000000000000000000000000001
100200000000002000000000000000000000000000000200000000000001
100002000000000000000000000000000000000000000000000000000001
100000000000000000000000000000000000000000000000000000000001
100000000000000000001111111111111111111111111100000000000001
100000000000000000001111111111111111111111111100000000000001
100020000000000000001111111111111111111111111100000000000001
100000000000000200001111111111111111111111111100000000000001
100000000000000000000000000000000000000000000000000000000001
100000200000000000000000000000002000000000000000000000000001
100000000000000000000000000000000000000000000000000000000001
100000000000000000001111111111111111111111111100000000000001
100000000000000000001111111111111111111111111100000000000001
100000000000000000001111111111111111111111111100020000000001
100000000000000000001111111111111111111111111100000000000001
100000000000000000000000000000000000000000000000000000000001
100000000000000000000000000000000000000000000200020000000001
10000000002000000000000000P000000000000000000000000000000001
100000000000000000000000000000000000000000000000000000000001
100000002000000000000GGGGGGGGGGGG000000000000000000002000001
100000000000000000000GGGGGGGGGGGG000000000000000000000000001
100000000000000000000GGGGGGGGGGGG000000000000000000000000001
100000000000000000000000000000000000000000000000020000000001
100000000000000000000000000000000000000000000000000000000001
100000020000000000111111100000000000001111111100000000000001
100000000000000000111111100000000000001111111100000000000201
100000000000000000111111100000000000001111111100020000000001
100000020000000020111111100000000000001111111100000000000001
100000000000000000111111100000000000001111111100000000000001
100000000000000000111111100000000000001111111100000000000001
100000000000000000111111100000000002001111111100000002000001
100000000000000002111111100000000000001111111100000000000001
100000000000000000000000000000000000001000000000000000000001
100000200000000000000000000000000000001000000000000000002001
100000000000000000111111100000000000001000200000000000000001
100000000000000000111111100000000000001000000000000000000001
100000200000000000111111100000000000001000000000020200000001
100000000000000000111111100000000000001000000000000000000001
100000000000000000111111100000000000001000000000000000000001
100000000000000000111111100000000000001000000000020000000001
100000000000000000111111100000000000001000000000000000000001
1S00000000000000001111111000000000000010000000000000000000S1
111111111111111111111111111111111111111111111111111111111111