111111111111111111111111111111111111111111111111111111111111
1S00000200000200000000000000000000000000200000000000000000S1
100000000020200000000000000000000000000000000000000000000001
100200000000002200000000000000000000000000000200000000000001
100002000000000000000000000000000000000000000000000000000001
100000000000000200000000000000000000000000000000000000000001
100000000000000000000000000000000000000000000000000000000001
100000020000020000000200000000000002000200000200000000000001
100020000020200000000000000000000000000000202000000000000001
100000000000002200000000000000000000000000000022000000000001
100000000000000000000000000000000000000000000000000000000001
100000200000000000000000000000002000000000000000000000000001
100000000000000000000000000000000000000000000000000000000001
100000000000000000000000000000000000000000000000000000000001
100000000000000000000000000000000000000000000000000000000001
100000000000000000000000000000000000000000000000020000000001
100000000000000000000000000000000000000200000200000000000001
100000000000000000000000000000000000000000202000000000000001
100000000000000000000000000000000000000000000022020000000001
10000000002000000000000000P000000000000000000000000000000001
100000000000000000000000000000000000000000000000000000000001
100000002000000000000GGGGGGGGGGGG000000000000000000002000001
100000000000000000000GGGGGGGGGGGG000000000000000000000000001
100000000000000000000GGGGGGGGGGGG000000000000000000000000001
100000000000000000000000000000000000000000000000020000000001
100000000000000000000000000000000000000000000000000000000001
100000020000000000000000000000000000000200000000000000000001
100000000000000000000000000000000000000200000200000000000201
100000000000000000000000000200000200000000000000200000002001
100000020000000020000000000000202000000000000000000020022001
102000002000000000000000000000000022000000000000000000000001
100002020000000000000000000000000000000000000000000000000001
100000000220000000000000000000000000200000000000000000200001
100000000000000002000000000000000000000000000000000000000001
100000000000000000000000000000000000000000000000000000000001
100000200000000000000000000000000000000000000000000000002001
100000000000000000000000000000000000000000200000000000000001
100000000000000000000000000000000000000000000000000000000001
100000200000000000000000200000000000000000000000020200000001
100000000000000000000000000000000000000000000000000000000001
100000000000000000000000000000000000000000000000000000000001
100000000000000000000200000000000000000000000000020000000001
100000000000000000000000000000000000000000000000000000000001
1S00000000000000000000000000000000000000000000000000000000S1
111111111111111111111111111111111111111111111111111111111111